{
  "Level 1 - 🐟": [
    "################## #################",
    "#PO..##....F...............C....DO.#",
    "#.##.##.######.###.##ce##.##.#.#####.#",
    "#1...#....#.....#H.#.......#.......#",
    "#.##.#.##.#.###########.##.#.#####.#",
    "#....#.......M..........#..#.......#",
    "#.######.##############.#.######.#.#",
    "#........#............#.#........#.#",
    " .########.##########.#.##########. ",
    "#....P.........................F...#",
    "#.#####.######.############.####.#.#",
    "#.......#....#............#....#...#",
    "#.#####.#.##.############.#.##.###.#",
    "#...C...#.H#..........M...#.H#..W..#",
    "#.#.########.###################.#.#",
    "#.O............................D.O.#",
    "################## #################"
  ],
  "Level 2 - 🍩": [
    "################## #################",
    "#P....#......F............##...C...#",
    "#.###.#.###H##H#########.##H####.#.#",
    "#...#.#....#.H#...........#....#.#.#",
    "###.#.####.#.############.####.#.#.#",
    "#...#......#..........M...#....#...#",
    "#.##########.############.#.######.#",
    "#........#...#.##.......#.#........#",
    " .######.#.###.#H######.#.########. ",
    "#.#...##.#.....#.. .........F..#...#",
    "#.#.##.#.##############.#####.##.#.#",
    "#......#......#.............#..#...#",
    "#.####.######.#.###########.##.###.#",
    "#...C......#..#..........M..#......#",
    "###.######.#.##############.#.####.#",
    "#D...........#....................P#",
    "################## #################"
  ],
  "Level 3 - ☕️": [
    "################## #################",
    "#P......#....F..........#......C...#",
    "#.#######.######.#####.##.########.#",
    "#.......#......#.#...#..#........#.#",
    "#######.######.#.#.#H##.######.#.#.#",
    "#.....#....M...#.#.###.......#.#...#",
    "#.###.########.#.#.#H#.#####.#.###.#",
    "#.#.#..........#.....#...#.#.......#",
    " .#.##################.#.#.#.#####. ",
    "#.#....F.......... ....#.#.#.....#.#",
    "#.#######.##############.#.#####.#.#",
    "#.......#......#.....#...#.....#...#",
    "#.#####.######.#H#.#H#.#######.###.#",
    "#...C.#....M...###.###.........#...#",
    "###.#.########.#H#.#H###########.#.#",
    "#D..#...........................P..#",
    "################## #################"
  ],
  "Level 4 - 🥤": [
    "################## #################",
    "#P..........F...............C.#....#",
    "#.##H######.###########.######H###.#",
    "#.#H#.......#.H#........#..........#",
    "#....######.#.#########.#.#.######.#",
    "#.##.#....#.#.#.......#.#.#......#.#",
    "#.##.#.##.#.#.#.#####.#.#.#.####.#.#",
    "#....#.##.#...#.#...#...#.#......#.#",
    " .####.##.#####.#.#.#.###.########. ",
    "#......M.......... ..C.............#",
    "#.########.############.######.###.#",
    "#........#............#.....#......#",
    "#.######.######.#####.###H#.######.#",
    "#......#......F..........#.........#",
    "#.####.#.####################.####.#",
    "#D..............................P..#",
    "################## #################"
  ],
  "Level 5 - 🧋": [
    "################## #################",
    "#P........#...F...............#.C..#",
    "###.######H############.######H#.#.#",
    "#..........#....................#H.#",
    "#.#######.#H############.#.#####H#.#",
    "#.......#.#..............#.#.......#",
    "#.#####.#.##########.#####.#.#####.#",
    "#.....#.#.....M............#.#.....#",
    " .###.#.#.###.############.#.#.###. ",
    "#.....#.#......... ........#.#.....#",
    "#.#####.#.###########.####.#.#####.#",
    "#.......#.#..............#.#.......#",
    "#.#####.#.###.############.#.#####.#",
    "#......C......F..................P.#",
    "#.######.######.#####.######.#####.#",
    "#D.................................#",
    "################## #################"
  ],
  "Level 6 - ✂️": [
    "################## #################",
    "#P............F........#........C..#",
    "#.#H######.############H#########.##",
    "#.H#...............................#",
    "#.######.#.################.#.####.#",
    "#.#.H#...#.#..............#.#....#.#",
    "#.#.####.#.#.############.#.#.####.#",
    "#.#.#H.#.#.#.#..........#.#.#......#",
    " .#.##.#.#.#.#.########.#.#.######. ",
    "#.#....#.#...#.... ..M..#.#.....F..#",
    "#.#.####.#####.##########.#.####.#.#",
    "#.#......#............#.....#....#.#",
    "#.########.############.#####.####.#",
    "#.....C..........................#.#",
    "#.####.#####.############.####.###.#",
    "#D..............................P..#",
    "################## #################"
  ],
  "Level 7 - 🍉": [
    "################## #################",
    "#P............F.................C..#",
    "#.##########.############.#######.##",
    "#..................................#",
    "##.######H#H#####.#######.########.#",
    "#........#.#............#.#........#",
    "#.######.#.###.#########H.#.######.#",
    "#......#.#...........M.##.#.##.....#",
    " .######.##########.######H#.H####. ",
    "#......#.......... ........#.#.....#",
    "#.######.#####.#############.#####.#",
    "#......#.....#............#........#",
    "#.####.#.###.#.############.######.#",
    "#......#.....#............C........#",
    "#.######.######.#####.######.#######",
    "#D..............................F..#",
    "################## #################"
  ],
  "Level 8 - 🧇": [
    "################## #################",
    "#P...##....F..........#....C.......#",
    "#.##.##.######.###.####.##H######..#",
    "#....#....#....#...#......#.......##",
    "####.#.##.#.##############H#.#######",
    "#....#.H#....M..........#..#.......#",
    "#.######H##############.#.######.#.#",
    "#........#............#.#........#.#",
    " .########.##########.#.##########. ",
    "#....P............ ..B.........F...#",
    "#######.######.############.####.###",
    "#.......#....#............#....#...#",
    "#.#####.#.##.############.#.##.###.#",
    "#...C...#.H#..........M...#.H#.....#",
    "#.#.########.####################.##",
    "#D...........................F..C..#",
    "################## #################"
  ],
  "Level 9 - 🍦": [
    "################## #################",
    "#P....#......F............##...C...#",
    "#.###.#.###H##H#########.##H####.#.#",
    "#...#.#....#.H#...........#....#.#.#",
    "###.#.####.#.############.####.#.#.#",
    "#...#......#..........M...#....#...#",
    "#.##########.############.#.######.#",
    "#........#...#.##.......#.#........#",
    " .######.#.###.#H######.#.########. ",
    "#.#...##.#.....#.. .........F..#...#",
    "#.#.##.#.##############.#####.##.#.#",
    "#.....C#......#.............#..#...#",
    "#.####.######.#.###########.##.###.#",
    "#..........#..#..........M..#......#",
    "###.######.#.##############.#.####.#",
    "#D.....F.....#....................P#",
    "################## #################"
  ],
  "Level 10 - 🍰": [
    "################## #################",
    "#P......#....F..........#......C...#",
    "#.#######.######.#####.##.########.#",
    "#.......#......#.#...#..#........#.#",
    "#######.######.#.#.#H##.######.#.#.#",
    "#.....#....M...#.#.###.......#.#...#",
    "#.###.########.#.#.#H#.#####.#.###.#",
    "#.#.#..........#.....#...#.#.......#",
    " .#.##################.#.#.#.#####. ",
    "#.#....F.......... ....#.#.#.....#.#",
    "#.#######.##############.#.#####.#.#",
    "#.......#......#.....#...#.....#...#",
    "#.#####.######.#H#.#H#.#######.###.#",
    "#...C.#....M...###.###.........#...#",
    "###.#.########.#H#.#H###########.#.#",
    "#D..#...C....................F..P..#",
    "################## #################"
  ],
  "Level 11 - 👀": [
    "################## #################",
    "#P..........F...............C.#....#",
    "#.##H######.###########.######H###.#",
    "#.#H#.......#.H#........#..........#",
    "#....######.#.#########.#.########.#",
    "#.##.#....#.#.#.......#.#.#......#.#",
    "#.##.#.##.#.#.#.#####.#.#.#.####.#.#",
    "#....#.##.#...#.#...#...#........#.#",
    " .####.##.#####.#.#.#.###.########. ",
    "#......M.......... ..C.............#",
    "#.########.############.######.###.#",
    "#........#............#.....#......#",
    "#.######.######.#####.###H#.######.#",
    "#......#......F..........#.........#",
    "#.####.#.####################.####.#",
    "#D....F.........................P..#",
    "################## #################"
  ],
  "Level 12 - 👁️": [
    "################## #################",
    "#D..............................P..#",
    "#.####.#####.############.####.###.#",
    "#.....C.........................#H.#",
    "#.########.############.#####.####.#",
    "#.#......#..................#....#.#",
    "#.#.####.#####.########.#.#.####.#.#",
    "#.#....#.#...#....M.....#.#.....F..#",
    " ...##...#.#.#.########.#.#.######. ",
    "#.#.#H.#.......... ................#",
    "#.#.####.#.#.############.#.#.####.#",
    "#.#.H#...#.#..............#.#....#.#",
    "#.######.#.################.#.####.#",
    "#.H#...............................#",
    "#.#H######.############.###.######.#",
    "#P............F.................C..#",
    "################## #################"
  ]
}
